Финансовое	ADJ
обеспечение	NOUN
деятельности	NOUN
Федерального	ADJ
государственного	ADJ
автономного	ADJ
образовательного	ADJ
учреждения	NOUN
высшего	ADJ
профессионального	ADJ
образования	NOUN
ФГОАУ	NOUN
ВПО	NOUN
Национального	ADJ
исследовательского	ADJ
университета	NOUN
Высшая	ADJ
школа	NOUN
экономики	NOUN
далее	ADV
НИУ	NOUN
ВШЭ	NOUN
за	ADP
счет	ADP
средств	NOUN
федерального	ADJ
бюджета	NOUN
осуществляет	VERB
Управление	NOUN
делами	NOUN
Президента	NOUN
Российской	ADJ
Федерации	NOUN
К	ADP
2018	NUM
году	NOUN
100	NUM
ООП	NOUN
ВПО	NOUN
прошли	VERB
экспертизу	NOUN
с	ADP
участием	NOUN
международных	ADJ
экспертов	NOUN
Под	ADP
Марксом	NOUN
в	ADP
кресло	NOUN
вкресленный	VERB
с	ADP
высоким	ADJ
окладом	NOUN
высок	ADJ
и	CONJ
гладок	ADJ
сидит	VERB
облачённый	VERB
ответственный	ADJ
Каждый	PRON
на	ADP
месте	NOUN
невеста	NOUN
в	ADP
тресте	NOUN
кум	NOUN
в	ADP
Гум	NOUN
брат	NOUN
в	ADP
наркомат	NOUN
Все	PART
шире	ADV
периферия	NOUN
родных	NOUN
и	CONJ
в	ADP
ведомостичках	NOUN
узких	ADJ
не	PART
вместишь	VERB
всех	PRON
сортов	NOUN
наградных	ADJ
спецставки	NOUN
тантьемы	NOUN
нагрузки	NOUN
Зайдите	VERB
еще	ADV
через	ADP
день-другой	ADV
Но	CONJ
дней	NOUN
не	PART
дождаться	VERB
жданных	VERB
И.	NOUN
о.	NOUN
директора	NOUN
был	VERB
назначен	VERB
Ст.	ADJ
преподаватель	NOUN
преподает	VERB
курсы	NOUN
Канд.	NOUN
техн.	ADJ
наук	NOUN
проводит	VERB
исследования	NOUN
Ст.	ADJ
научн.	ADJ
сотр.	NOUN
активно	ADV
публикует	VERB
статьи	NOUN
Ген.	ADJ
директор	NOUN
компании	NOUN
Мария	NOUN
По	ADP
рзеузльаттам	NOUN
илссоевадний	NOUN
одонго	DET
анлигсйокго	ADJ
унвиертисета	NOUN
не	PART
иеемт	VERB
занчнеия	NOUN
в	ADP
каокм	DET
проякде	NOUN
рсапжоолены	VERB
бкувы	NOUN
в	ADP
солве	NOUN
Я	PRON
убедю	VERB
тебя	PRON
в	ADP
обратном	NOUN
Сегодня	ADV
я	PRON
тебя	PRON
побежду	VERB
Вода	NOUN
еще	ADV
не	PART
стекла	VERB
до	ADP
конца	NOUN
Ну-ка	INTJ
мечи	VERB
стаканы	NOUN
на	ADP
стол	NOUN
и	CONJ
прочую	DEM
посуду	NOUN
Я	PRON
не	PART
хотел	VERB
тянуть	VERB
баржу	NOUN
поэтому	CONJ
я	PRON
хожу-брожу	VERB
Светлонный	ADJ
день	NOUN
бывает	VERB
а	CONJ
ночь	NOUN
не	PART
бывает	VERB
она	PRON
темнонная	ADJ
потому	CONJ
что	CONJ
ночью	NOUN
не	PART
бывает	VERB
светло	ADV
Памимимный	ADJ
день	NOUN
это	PART
когда	ADV
памимишки	NOUN
Некоторые	DET
эксперты	NOUN
описывают	VERB
ситуации	NOUN
моджибаке	NOUN
когда	ADV
текстовые	ADJ
данные	NOUN
отправляются	VERB
между	ADP
компьютерами	NOUN
с	ADP
разными	ADJ
кодировками	NOUN
по	ADP
умолчанию	NOUN
С	ADP
косой	ADJ
косой	NOUN
в	ADP
косой	ADJ
косе	NOUN
за	ADP
косарь	NOUN
от	ADP
косой	ADJ
косы	NOUN
к	ADP
косой	ADJ
косе	NOUN
кося	VERB
косой	ADJ
косацкий	ADJ
косарь	NOUN
Косарь	NOUN
из	ADP
Косы	NOUN
косой	ADJ
косой	NOUN
косого	ADJ
косо	ADV
косил	VERB
косую	ADJ
косу	NOUN